    #####            
    #   #            
    #$  #            
  ###  $###          
  #  $  $ #          
### # ### #     ######
#   # ### #######  00#
# $  $             00#
##### #### #@####  00#
    #     ###  ######
    ########         
