    #####             
    #   #             
    #$ $#             
  ###   ###           
  #   $   #           
### # ### #     ######
#   #$### #######  OO#
# $   @$           OO#
##### #### # ####  OO#
    #      ###  ######
    ########          
                      
                      
0 asdf 5
